2 8 10 2
13 7 1 1
15 6 1 1
18 8 2 1
22 9 2 1
26 9 1 1
28 9 1 1
30 9 1 1
32 9 1 1
34 9 4 1
40 9 1 1
43 9 1 1
47 9 1 1
49 9 1 1
51 8 2 1
54 7 1 1
56 6 1 1
58 9 2 1
X 45 9 1 1
X 36 8 1 1
X -5 11 60 1
F 2 7 1 1