0 7 4 4
5 5 1 6
8 3 1 8
11 2 1 9
13 9 9 2
X 13 8 1 1
X 14 8 1 1
X 15 8 1 1
X 16 8 1 1
X 18 8 1 1
X 19 8 1 1
X 20 8 1 1
X 21 8 1 1
X -5 11 30 1
F 17 8 1 1