8 8 2 1
13 8 2 1
18 8 2 1
23 8 2 1
26 7 2 1
27 6 7 1
37 8 4 1
X 0 11 50 1
F 40 7 1 1