0 5 1 5
0 9 13 1
12 8 1 2
17 9 2 1
19 7 6 3
25 9 2 1
28 9 1 1
31 9 1 1
35 9 4 1
40 7 1 1
44 9 3 1
47 6 2 4
48 5 1 1