0 9 13 1
16 9 11 1
28 9 1 1
31 9 1 1
35 9 4 1
40 7 1 1
44 9 5 1