0 7 4 4
7 5 1 1
11 4 1 1
15 3 1 1
19 2 1 1
23 1 1 1
28 2 1 1
34 8 4 1
42 7 1 1
44 5 1 1
47 3 4 2
X -5 12 70 1
F 50 2 1 1