6 8 15 2
23 6 1 4
26 5 1 5
29 9 8 1
X 10 3 1 1
X 14 4 1 1
X 18 4 1 1
X 10 8 1 1
X 14 8 1 1
X 18 8 1 1
X 0 11 40 1
F 36 8 1 1